{
    "tileset": "tileset_grass.png",
    "map": [
        [255, 255, 255, 255, 255, 255, 255, 255, 255, 255, 255, 255, 255, 255, 255, 255, 255, 255, 255, 255],
        [255, 255, 255, 255, 255, 255, 255, 255, 255, 255, 255, 255, 255, 255, 255, 255, 255, 255, 255, 255],
        [255, 255, 255, 255, 255, 255, 255, 255, 255, 255, 255, 255, 255, 255, 255, 255, 255, 255, 255, 255],
        [255, 255, 255, 255, 255, 255, 255, 255, 255, 255, 255, 255, 255, 255, 255, 255, 255, 255, 255, 255],
        [255, 255, 255, 255, 255, 255, 255, 255, 255, 255, 255, 255, 255, 255, 255, 255, 255, 255, 255, 255],
        [255, 255, 255, 255, 255, 255, 255, 255, 255, 255, 255, 255, 255, 255, 255, 255, 255, 255, 255, 255],
        [255, 255, 255, 255, 255, 255, 255, 255, 255, 255, 255, 255, 255, 255, 255, 255, 255, 255, 255, 255],
        [255, 255, 255, 255, 255, 255, 255, 255, 255, 255, 255, 255, 255, 255, 255, 255, 255, 255, 255, 255],
        [255, 255, 255, 255, 255, 255, 255, 255, 255, 255, 255, 255, 255, 255, 255, 255, 255, 255, 255, 255],
        [255, 255, 255, 255, 255, 255, 255, 255, 255, 255, 255, 255, 255, 255, 255, 255, 255, 255, 255, 255],
        [255, 255,   6,   3,   3,   3,   3,   3,   3,   3,   3,   3,   3,   3,   3,   3,   3,   7, 255, 255],
        [255, 255,  22,  18, 183, 100, 100, 100, 100, 100, 100, 100, 100, 100, 100, 182,  18,  23, 255, 255],
        [255, 255, 255, 255,  26,  18,  18,  18,  18,  18,  18,  18,  18,  18,  18,  27, 255, 255, 255, 255],
        [255, 255, 255, 255, 255, 255, 255, 255, 255, 255, 255, 255, 255, 255, 255, 255, 255, 255, 255, 255],
        [255, 255, 255, 255, 255, 255, 255, 255, 255, 255, 255, 255, 255, 255, 255, 255, 255, 255, 255, 255]
    ],
    "player": {
        "position": {"x": 320, "y": 100},
        "flip": false
    },
    "entities": [],
    "collisions": [
        {"x":  64, "y": 320},
        {"x": 320, "y": 300},
        {"x": 576, "y": 320},
        null,
        {"x": 600, "y": 320},
        {"x": 300, "y": 200}
    ]
}
