{
    "tileset": "tileset_grass.png",
    "map": [
        [255, 255, 255, 255, 255, 255, 255, 255, 255, 255, 255, 255, 255, 255, 255, 255, 255, 255, 255, 255],
        [255, 255, 255, 255, 255, 255, 255, 255, 255, 255, 255, 255, 255, 255, 255, 255, 255, 255, 255, 255],
        [255, 255, 255, 255, 255, 255, 255, 255, 255, 255, 255, 255, 255, 255, 255, 255, 255, 255, 255, 255],
        [255, 255, 255, 255, 255, 255, 255, 255, 255, 255, 255, 255, 255, 255, 255, 255, 255, 255, 255, 255],
        [255, 255, 255, 255, 255, 255, 255, 255, 255, 255, 255, 255, 255, 255, 255, 255, 255, 255, 255, 255],
        [255, 255, 255, 255, 255, 255, 255, 255, 255, 255, 255, 255, 255, 255, 255, 255, 255, 255, 255, 255],
        [255, 255, 255, 255, 255, 255, 255, 255, 255, 255, 255, 255, 255, 255, 255, 255, 255, 255, 255, 255],
        [255, 255, 255, 255, 255, 255, 255, 255, 255, 255, 255, 255, 255, 255, 255, 255, 255, 255, 255, 255],
        [255, 255, 255, 255, 255, 255, 255, 255, 255, 255, 255, 255, 255, 255, 255, 255, 255, 255, 255, 255],
        [255, 255, 255, 255, 255, 255, 255, 255, 255, 255, 255, 255, 255, 255, 255, 255, 255, 255, 255, 255],
        [255, 255,   6,   3,   3,   3,   3,   3,   3,   3,   3,   3,   3,   3,   3,   3,   3,   7, 255, 255],
        [255, 255,  22,  18, 183, 100, 100, 100, 100, 100, 100, 100, 100, 100, 100, 182,  18,  23, 255, 255],
        [255, 255, 255, 255,  26,  18,  18,  18,  18,  18,  18,  18,  18,  18,  18,  27, 255, 255, 255, 255],
        [255, 255, 255, 255, 255, 255, 255, 255, 255, 255, 255, 255, 255, 255, 255, 255, 255, 255, 255, 255],
        [255, 255, 255, 255, 255, 255, 255, 255, 255, 255, 255, 255, 255, 255, 255, 255, 255, 255, 255, 255]
    ],
    "player": {
        "position": {"x": 320, "y": 100},
        "flip": false
    },
    "entities": [],
    "collisions": [
        {"x1": 64, "y1": 320, "x2": 576, "y2": 320}
    ]
}
